Xin chào mọi người [cười], mình là Hội đó.	Hi, my name is Hoi.
Sao hôm nay ngồi trước biển, tự nhiên Hội muốn kể cho mọi người nghe	I want to tell you a story about love
một câu chuyện tình yêu và những niềm đau chôn giấu.	I want to tell you a story about love and the agony of love lost.
Ý, đừng có lo, Hội không tính tiền đâu. Tập trung nghe nha…	No worries, no charges at all. Now listen carefully.
Câu chuyện bắt đầu, giống như cách mà ta hay kể đó.	It starts the way every story starts.
Ngày xửa ngày xưa, có một chàng công chúa xinh đẹp…	Once upon a time, there was a beautiful, male princess…
[Hội] Đây chính là nơi trái tim người ta từng tan nát,	It's the place where my heart shattered,
mất hết hy vọng tìm được tình yêu vĩnh cửu nè.	and the hope for The One was lost.
[Kathy] Nhưng ngay sau đó,	But after that,
bà đụng vô cái gì cũng đẻ ra tiền hết rồi còn muốn gì nữa?	all your investment turned into gold. What more do you want?
[Hội] Ôm cả đống tiền mà tối ngày thui thủi một mình	A huge pile of money but all alone, where is the joy in that?
‪cũng không sung sướng gì đâu.‬	A huge pile of money but all alone, where is the joy in that?
[Kathy] Bà tập trung chuẩn bị cho buổi thuyết trình đi.	Just focus on the presentation today.
Xin chào!	Hello.
- Lý do anh đến Việt Nam làm gì? - Để…	Why did you come to Vietnam?
biến những giấc mơ hoang dại nhất của Hội thành sự thật.	To make my wildest dreams come true.
- [nhân viên an ninh] Xong rồi! - [thở dài]	All done.
Sao lẹ dạ?	Why so fast?
Đúng ra, anh phải khám xét toàn thân Hội.	Technically you should give me a full body search.
Không thích gái đẹp hả?	Don't you like pretty girls?
CÔ HỘI	MISS HOI
Hội là chị nè cưng.	Miss Hoi is here.
Để tôi xách hành lý cho bé Hội.	Let me take your bags.
Xích ra, xích ra, xích ra…	Move away.
Giơ tay lên. Giơ lên!	Put your hands up.
Để yên đó.	Stay still.
Nè, tỏi là để ăn,	Listen, garlic is for eating,
chứ không phải để kẹp vô nách nghe chưa?	not for your pits.
- Đi! - [Hội] Đi!	Let's go.
Kể từ giờ phút này, tôi là trợ lý đặc biệt của Hội đó.	From now on, I'm your special assistant! Do a good job and I'll give you money
Ráng phục vụ tốt đi,	Do a good job and I'll give you money to cure your odor and pluck your nose hair.
rồi Hội cho tiền đi mổ nách với tỉa lông mũi.	to cure your odor and pluck your nose hair.
Ê, bậy! Cái này đâu phải lông mũi.	Hey! This isn't just nose hair.
Râu tài của người ta đó cha.	It's my lucky nose hair.
- [Hội] Râu tài đó hả? - Ừ.	-Lucky nose hair? -Yep!
Mấy thứ ông Phạm Hương Hội yêu cầu đã xong hết chưa em?	Have all of Pham Huong Hoi's requests been met?
Dạ.	Yes, done.
Ổng là khách VIP khó tính nhất của mình đó.	He's our most difficult VIP guest.
Dạ rồi, em đã phải kiểm tra đến ba lần rồi đó.	Don't worry, I triple checked the list.
Chị.	Boss,
Anh chàng họa sĩ đó lại nhìn chị nữa kìa.	that painter is staring at you again.
Em nhiều chuyện quá nha Quyên.	Don't be a big mouth, Quyen.
- Chào hai quý cô. - [Quyên] Ơ.	Hello, lovely ladies.
Anh Sơn.	Hi, Anh Son.
Anh tặng em.	For you.
Ba em có nói tối nay anh qua ăn tối rồi chứ?	Did your father tell you I was coming over for dinner?
Em chưa nghe ba nói gì hết.	He didn't say anything.
Hôm nay anh qua không phải là để bàn công việc với ba đâu.	I'm not coming to discuss business with your father.
Tối nay em phải đi thăm mấy đứa nhỏ trong bệnh viện nữa.	Well, tonight I have to go visit the children at the hospital.
Vậy… để cuối tuần cũng được.	Then we can do it this weekend instead.
[Kathy] Tới rồi hả?	Arrived?
Hội yêu cầu anh một hot boy thật thơm tho,	I asked for a golden hot boy
mà cuối cùng anh đưa cho Hội ông chủ vựa tỏi.	and you gave me the King of Garlic.
Trời ơi, bộ tính ám sát Hội hả trời?	My God, are you trying to ambush me?
[Kathy] Tôi chỉ muốn bà tập trung vào cuộc họp với nhà đầu tư.	I just want you to focus on your investors' meeting.
[Hội] Nè, sao? Bộ giờ không tin Hội hả?	What, you don't trust me?
Nhà băng không có làm việc bằng niềm tin.	The bank doesn't do business solely on "trust."
Thì còn cái villa của Hội ở New York đó.	How about my New York villa?
[Hội] Thế chấp đi.	That's mortgaged.
Bà đã cầm cái villa đó rồi.	You've sold it already.
Thì… cái spa ở Malibu?	How about the Malibu spa?
Chưa đủ, và họ còn muốn lấy thêm căn nhà ở Beverly Hills nữa.	Not enough. They want your Beverly Hills estate too.
Cũng có sao đâu, cứ đưa cho họ đi.	That's fine. Just give it to them.
Hội ấp ủ cái dự án này lâu lắm rồi.	I've been nurturing it for so long.
Bằng mọi giá, Hội phải làm cho bằng được.	I have to make it happen no matter what.
Tất nhiên rồi, nếu không là hai đứa mình sẽ phá sản.	Of course. Or else we'll both be bankrupt.
[Hội] Nè.	Here you go.
Đánh bóng hả?	You want a spank?
Bóng có tội gì mà đánh người ta? Đánh láng lên!	Why would I want to get spanked? Just shine them!
Bóng láng.	Shiny spank then.